SPRITEMAP
25 18 							-- Size of tile map in tiles
24 24 							-- Tile size & block size
images/baba_sprites.png 		-- Tilesheet
32 66 							-- Number of tiles in tilesheet
401 401 401 401 401 401 401 401 401 401 401 401 401 401 401 401 401 401 401 401 401 401 401 401 401 
401 871 979 1365 0 0 0 0 0 0 0 0 0 0 0 0 0 0 0 0 0 0 0 0 401 
401 961 892 1073 0 0 0 0 0 1834 1830 1830 1830 1830 1830 1830 1830 1837 0 0 0 0 0 0 401 
401 1084 979 1357 0 0 0 0 0 1835 0 0 0 0 0 0 0 1835 0 0 0 0 0 0 401 
401 1073 979 1254 0 0 0 0 0 1835 0 0 1362 0 0 0 0 1835 0 0 0 0 0 0 401 
401 0 0 0 0 0 0 0 0 1828 1830 1830 1829 492 1826 1830 1830 1831 0 0 0 0 0 0 401 
401 0 0 4 0 0 0 0 0 0 0 0 0 0 0 0 0 0 0 0 0 0 0 0 401 
401 0 0 0 0 0 0 679 0 0 0 0 0 0 0 0 0 0 0 0 0 0 0 0 401 
401 0 0 0 0 0 0 0 0 0 0 0 0 0 0 0 0 0 0 0 0 0 0 0 401 
401 0 0 0 0 0 0 0 0 0 0 0 0 0 0 0 0 0 0 0 0 0 0 0 401 
401 0 0 1834 1830 1830 1830 1830 1837 0 0 0 0 0 0 0 0 0 0 0 0 0 0 0 401 
401 0 0 1835 0 0 0 0 1827 0 0 0 0 0 1834 1830 1830 1829 0 0 0 0 0 0 401 
401 0 0 1835 0 962 0 0 492 0 0 0 0 0 1835 0 0 492 0 0 0 0 0 0 401 
401 0 0 1835 0 0 0 0 1833 0 0 0 0 0 1835 0 979 1833 0 0 0 0 0 0 401 
401 0 0 1828 1830 1830 1830 1830 1831 0 0 0 0 0 1835 0 0 1828 1830 1830 1837 0 0 0 401 
401 0 0 0 0 0 0 0 0 0 0 0 0 0 1828 1830 1830 1830 1830 1830 1831 0 0 0 401 
401 0 0 0 0 0 0 0 0 0 0 0 0 0 0 0 0 0 0 0 0 0 0 0 401
401 401 401 401 401 401 401 401 401 401 401 401 401 401 401 401 401 401 401 401 401 401 401 401 401 