SPRITEMAP
25 18 							-- Size of tile map in tiles
24 24 							-- Tile size & block size
images/baba_sprites.png 		-- Tilesheet
32 66 							-- Number of tiles in tilesheet
401 401 401 401 401 401 401 401 401 401 401 401 401 401 401 401 401 401 401 401 401 401 401 401 401 
401 0 0 0 0 0 0 0 0 0 0 0 0 0 0 0 0 0 0 0 0 0 0 0 401 
401 0 0 0 0 0 0 0 0 0 0 0 0 0 0 0 0 0 0 0 0 0 0 0 401 
401 0 0 0 0 0 0 0 0 0 0 0 0 0 0 0 0 0 0 0 0 0 0 0 401 
401 0 0 0 0 0 0 0 0 0 0 0 0 0 0 0 0 0 0 0 0 0 0 0 401 
401 0 0 0 0 0 0 871 979 1365 0 0 0 0 0 962 979 1362 0 0 0 0 0 0 401 
401 0 0 0 0 0 0 0 0 0 0 0 0 0 0 0 0 0 0 0 0 0 0 0 401 
401 0 0 0 0 0 0 0 0 0 0 0 0 0 0 0 0 0 0 0 0 0 0 0 401 
401 0 0 0 0 0 0 1826 1830 1830 1830 1830 1830 1830 1830 1830 1830 1829 0 0 0 0 0 0 401 
401 0 0 0 0 0 0 692 692 692 692 692 688 692 692 692 692 692 0 0 0 0 0 0 401 
401 0 0 0 0 0 0 692 4 692 692 692 688 692 692 692 679 692 0 0 0 0 0 0 401 
401 0 0 0 0 0 0 692 692 692 692 692 688 692 692 692 692 692 0 0 0 0 0 0 401 
401 0 0 0 0 0 0 1826 1830 1830 1830 1830 1830 1830 1830 1830 1830 1829 0 0 0 0 0 0 401 
401 0 0 0 0 0 0 0 0 0 0 0 0 0 0 0 0 0 0 0 0 0 0 0 401 
401 0 0 0 0 0 0 1084 979 1357 0 0 0 0 0 1068 979 1347 0 0 0 0 0 0 401 
401 0 0 0 0 0 0 0 0 0 0 0 0 0 0 0 0 0 0 0 0 0 0 0 401 
401 0 0 0 0 0 0 0 0 0 0 0 0 0 0 0 0 0 0 0 0 0 0 0 401
401 401 401 401 401 401 401 401 401 401 401 401 401 401 401 401 401 401 401 401 401 401 401 401 401