SPRITEMAP
25 18 							-- Size of tile map in tiles
24 24 							-- Tile size & block size
images/baba_sprites.png 		-- Tilesheet
32 66 							-- Number of tiles in tilesheet
401 401 401 401 401 401 401 401 401 401 401 401 401 401 401 401 401 401 401 401 401 401 401 401 401 
401 962 979 1362 0 0 0 0 0 0 0 0 0 0 0 0 0 0 0 0 0 0 0 0 401 
401 871 979 1365 0 0 0 0 0 0 0 0 0 0 0 0 0 0 0 0 0 0 0 0 401 
401 0 0 0 0 0 0 0 0 0 0 0 0 492 492 492 492 492 492 492 492 492 492 0 401 
401 0 0 0 0 0 0 0 0 0 0 0 0 492 0 0 0 0 0 0 0 0 492 0 401 
401 0 0 0 0 0 0 0 0 0 0 0 0 492 0 0 0 0 0 0 0 0 492 0 401 
401 0 1068 979 1347 0 0 0 0 0 0 0 0 492 0 1073 0 0 0 0 0 0 492 0 401 
401 0 0 0 0 0 0 0 0 0 0 0 0 492 0 979 0 0 0 0 0 0 492 0 401 
401 0 0 0 0 0 0 0 0 0 0 0 0 492 0 1254 0 0 0 0 0 0 492 0 401 
401 0 0 0 0 0 0 0 0 0 0 0 0 492 0 0 0 0 0 0 0 0 492 0 401 
401 0 0 0 0 0 0 0 0 0 0 0 0 492 0 0 0 0 0 0 0 0 492 0 401 
401 0 0 0 0 492 0 492 0 0 0 0 0 492 0 0 0 0 0 679 0 0 492 0 401 
401 0 0 0 0 492 688 492 0 0 0 0 0 492 0 0 0 0 0 0 0 0 492 0 401 
401 0 0 492 492 492 688 492 492 492 0 0 0 492 492 492 492 492 492 492 492 492 492 0 401 
401 0 0 492 0 0 688 0 0 492 0 0 0 0 0 0 0 0 0 0 0 0 0 0 401 
401 0 0 492 0 0 0 0 0 492 0 0 0 0 0 0 0 0 0 0 0 0 0 0 401 
401 0 0 492 0 0 4 0 0 492 0 0 0 0 0 0 0 0 0 0 0 0 0 0 401 
401 401 401 401 401 401 401 401 401 401 401 401 401 401 401 401 401 401 401 401 401 401 401 401 401 