SPRITEMAP
25 18 							-- Size of tile map in tiles
24 24 							-- Tile size & block size
images/baba_sprites.png 		-- Tilesheet
32 66 							-- Number of tiles in tilesheet
401 401 401 401 401 401 401 401 401 401 401 401 401 401 401 401 401 401 401 401 401 401 401 401 401 
401 0 0 0 0 0 0 0 0 0 0 0 0 0 0 0 0 0 0 0 0 0 0 0 401 
401 692 0 0 0 0 0 0 0 0 679 679 679 679 679 679 679 679 0 0 0 0 0 692 401 
401 0 0 0 692 0 0 0 0 0 679 0 0 0 0 0 0 679 0 0 0 0 0 0 401 
401 0 0 0 692 0 0 0 0 0 679 0 979 0 0 0 0 679 0 692 0 0 0 0 401 
401 0 0 0 0 0 679 679 679 679 679 0 0 0 0 0 0 679 0 692 692 0 0 0 401 
401 0 0 0 0 0 679 1642 1643 1643 1645 0 0 0 0 1362 0 679 0 0 0 0 0 0 401 
401 0 0 0 0 0 679 1643 871 1643 1643 0 0 0 0 0 0 679 0 0 0 0 0 0 401 
401 0 692 0 0 0 679 1636 1643 1643 1637 0 0 0 0 0 0 679 0 0 0 0 0 0 401 
401 692 0 0 0 0 679 679 679 679 679 679 679 679 679 679 679 679 0 0 0 0 0 0 401 
401 0 0 0 0 0 0 0 0 0 679 0 0 0 0 0 0 679 0 0 0 0 0 0 401 
401 0 0 0 0 0 0 1084 0 0 679 0 962 0 0 0 0 679 0 0 0 0 0 0 401 
401 0 0 0 0 0 0 979 0 0 679 0 979 0 0 1825 0 679 0 0 0 692 0 0 401 
401 0 0 4 0 0 0 1365 0 0 679 0 1357 0 0 0 0 679 0 0 0 0 0 0 401 
401 0 0 0 0 0 0 0 0 0 679 0 0 0 679 679 679 679 0 0 0 0 0 0 401 
401 0 0 0 692 0 0 0 0 0 679 679 679 679 679 0 0 0 0 692 692 0 0 0 401 
401 0 0 0 0 0 0 0 0 0 0 0 0 0 0 0 0 0 0 692 0 0 0 0 401 
401 401 401 401 401 401 401 401 401 401 401 401 401 401 401 401 401 401 401 401 401 401 401 401 401 