SPRITEMAP
25 18 							-- Size of tile map in tiles
24 24 							-- Tile size & block size
images/baba_sprites.png 		-- Tilesheet
32 66 							-- Number of tiles in tilesheet
401 401 401 401 401 401 401 401 401 401 401 401 401 401 401 401 401 401 401 401 401 401 401 401 401 
401 0 0 0 0 0 0 0 0 0 0 0 0 0 0 0 0 0 0 0 0 0 0 0 401 
401 0 0 0 0 0 1633 0 0 1834 1830 1830 1830 1830 1830 1830 1837 0 0 0 0 0 1633 0 401 
401 0 0 0 0 0 0 0 0 1835 0 0 0 0 0 0 1835 1633 0 0 0 0 0 0 401 
401 0 1633 0 0 0 0 0 0 1835 0 979 0 0 0 0 1835 0 1633 0 0 0 0 0 401 
401 0 0 0 0 0 0 0 0 1835 0 0 0 0 0 0 1835 0 0 0 0 0 0 0 401 
401 0 0 0 0 0 0 0 0 1835 0 0 0 0 0 0 1835 0 0 0 1633 0 0 0 401 
401 0 0 0 0 1834 1830 1830 1830 1831 0 0 0 0 1362 0 1835 0 0 0 0 0 0 0 401 
401 0 0 0 0 1835 692 692 692 692 0 0 0 0 0 0 1835 0 0 0 0 0 0 0 401 
401 1633 0 0 0 1835 692 962 692 692 0 0 679 0 0 0 1835 0 0 0 0 0 0 0 401 
401 0 1633 0 0 1835 692 692 692 692 0 0 0 0 0 0 1835 0 0 0 0 0 0 0 401 
401 0 0 0 0 1828 1830 1830 1830 1838 1830 1830 1830 1830 1830 1830 1839 0 0 0 0 1633 0 0 401 
401 0 0 0 0 0 0 0 0 1835 0 0 0 0 0 0 1835 0 0 0 1633 1633 0 0 401 
401 0 0 0 0 0 871 0 0 1835 0 1084 979 1357 0 0 1835 0 0 0 0 0 0 0 401 
401 0 0 0 0 0 979 0 0 1835 0 0 0 0 0 0 1835 0 0 0 0 0 0 0 401 
401 0 0 0 1633 0 1365 0 0 1835 0 0 4 0 0 0 1835 0 0 0 0 0 0 0 401 
401 0 0 0 0 0 0 0 0 1828 1830 1830 1830 1830 1830 1830 1831 0 0 0 0 0 0 0 401 
401 401 401 401 401 401 401 401 401 401 401 401 401 401 401 401 401 401 401 401 401 401 401 401 401 