SPRITEMAP
25 18 							-- Size of tile map in tiles
24 24 							-- Tile size & block size
images/baba_sprites.png 		-- Tilesheet
32 66 							-- Number of tiles in tilesheet
0 0 0 0 0 0 0 0 0 0 0 0 0 0 0 0 0 0 0 0 0 0 0 0 0 
0 0 0 0 0 0 0 0 0 0 0 0 0 0 0 0 0 0 0 0 0 0 0 0 0 
0 0 0 0 0 0 0 0 0 0 0 0 0 0 0 0 0 0 0 0 0 0 0 0 0 
0 0 0 0 0 0 0 0 0 0 0 0 0 0 0 0 0 0 0 0 0 0 0 0 0 
0 0 0 0 0 0 0 1754 1750 1750 1750 1750 1750 1750 1750 1750 1750 1757 0 0 0 0 0 0 0 
0 0 0 0 0 683 0 1755 0 0 0 0 0 0 0 0 0 1755 0 0 0 0 0 0 0 0 0 0 0 0 0 0 
0 0 0 0 0 0 0 1748 1750 1750 1750 1750 1750 1750 1750 1750 1750 1751 0 0 0 0 0 0 0 
0 0 0 0 0 0 0 1754 1750 1750 1750 1750 1750 1750 1750 1750 1750 1757 0 0 0 0 0 0 0 
0 0 0 0 0 683 0 1755 0 0 0 0 0 0 0 0 0 1755 0 0 0 0 0 0 0 0 0 0 0 0 0 0 
0 0 0 0 0 0 0 1748 1750 1750 1750 1750 1750 1750 1750 1750 1750 1751 0 0 0 0 0 0 0 
0 0 0 0 0 0 0 1754 1750 1750 1750 1750 1750 1750 1750 1750 1750 1757 0 0 0 0 0 0 0 
0 0 0 0 0 683 0 1755 0 0 0 0 0 0 0 0 0 1755 0 0 0 0 0 0 0 0 0 0 0 0 0 0 
0 0 0 0 0 0 0 1748 1750 1750 1750 1750 1750 1750 1750 1750 1750 1751 0 0 0 0 0 0 0 
0 0 0 0 0 0 0 1754 1750 1750 1750 1750 1750 1750 1750 1750 1750 1757 0 0 0 0 0 0 0 
0 0 0 0 0 683 0 1755 0 0 0 0 0 0 0 0 0 1755 0 0 0 0 0 0 0 0 0 0 0 0 0 0 
0 0 0 0 0 0 0 1748 1750 1750 1750 1750 1750 1750 1750 1750 1750 1751 0 0 0 0 0 0 0 
0 0 0 0 0 0 0 0 0 0 0 0 0 0 0 0 0 0 0 0 0 0 0 0 0 
0 0 0 0 0 0 0 0 0 0 0 0 0 0 0 0 0 0 0 0 0 0 0 0 0 
0 0 0 0 0 0 0 0 0 0 0 0 0 0 0 0 0 0 0 0 0 0 0 0 0 
0 0 0 0 0 0 0 0 0 0 0 0 0 0 0 0 0 0 0 0 0 0 0 0 0 
0 0 0 0 0 0 0 0 0 0 0 0 0 0 0 0 0 0 0 0 0 0 0 0 0 
0 0 0 0 0 0 0 0 0 0 0 0 0 0 0 0 0 0 0 0 0 0 0 0 0